//MAP CONVERTED BY dmm2tgm.py THIS HEADER COMMENT PREVENTS RECONVERSION, DO NOT REMOVE
"aK" = (
/obj/structure/chair/comfy/shuttle{
	dir = 4;
	name = "Driver's Seat"
	},
/obj/machinery/light/floor,
/obj/structure/cable{
	icon_state = "1-8"
	},
/obj/machinery/atmospherics/pipe/simple/supply/hidden/layer2{
	dir = 10
	},
/obj/machinery/atmospherics/pipe/simple/scrubbers/hidden/layer4{
	dir = 9
	},
/turf/open/floor/plasteel/tech,
/area/ship/bridge)
"bJ" = (
/obj/machinery/power/port_gen/pacman{
	anchored = 1
	},
/obj/structure/cable/yellow{
	icon_state = "0-8"
	},
/obj/structure/catwalk/over,
/turf/open/floor/plating,
/area/ship/engineering/engine)
"eJ" = (
/obj/machinery/atmospherics/components/unary/tank/air{
	dir = 1
	},
/obj/machinery/light{
	pixel_y = -30
	},
/obj/effect/turf_decal/techfloor/orange{
	dir = 4
	},
/turf/open/floor/plasteel/tech,
/area/ship/engineering/engine)
"gt" = (
/obj/machinery/atmospherics/pipe/layer_manifold/visible,
/obj/structure/tank_dispenser/oxygen,
/obj/effect/turf_decal/techfloor/orange{
	dir = 4
	},
/turf/open/floor/plasteel/tech,
/area/ship/engineering/engine)
"gN" = (
/turf/closed/wall/mineral/plastitanium/nodiagonal,
/area/ship/bridge)
"hn" = (
/obj/structure/cable{
	icon_state = "2-4"
	},
/obj/machinery/atmospherics/pipe/simple/supply/hidden/layer2{
	dir = 4
	},
/obj/machinery/atmospherics/pipe/simple/scrubbers/hidden/layer4{
	dir = 4
	},
/turf/open/floor/plasteel/tech,
/area/ship/engineering/engine)
"hv" = (
/obj/structure/chair/plastic{
	dir = 8
	},
/obj/machinery/atmospherics/components/unary/vent_pump/on/layer2{
	dir = 1
	},
/obj/structure/sink/kitchen{
	dir = 8;
	pixel_x = 14
	},
/obj/structure/mirror{
	pixel_x = 26;
	pixel_y = 2
	},
/turf/open/floor/plasteel/tech,
/area/ship/hallway/central)
"hB" = (
/obj/structure/window/reinforced,
/obj/structure/curtain/bounty,
/obj/structure/window/reinforced{
	dir = 8
	},
/obj/structure/closet/wall{
	dir = 4;
	pixel_x = -30;
	name = "wardrobe"
	},
/obj/item/clothing/suit/armor/vest/duster,
/obj/item/clothing/shoes/combat,
/obj/item/clothing/shoes/sneakers/black,
/obj/item/clothing/gloves/fingerless,
/obj/item/clothing/head/beret/black,
/obj/item/clothing/suit/vapeshirt,
/obj/item/clothing/under/pants/blackjeans,
/obj/item/reagent_containers/food/snacks/grown/ash_flora/fireblossom,
/obj/item/reagent_containers/food/snacks/grown/poppy,
/obj/structure/table/wood/reinforced,
/obj/item/clothing/under/shorts/black,
/obj/item/clothing/suit/armor/roumain,
/obj/item/storage/backpack/satchel/explorer,
/obj/structure/dresser{
	dir = 1
	},
/obj/item/clothing/under/syndicate/inteq,
/obj/item/clothing/under/pants/camo,
/turf/open/floor/wood/ebony,
/area/ship/crew)
"jz" = (
/obj/structure/table,
/obj/machinery/microwave{
	pixel_y = 15;
	pixel_x = -1
	},
/obj/machinery/reagentgrinder{
	pixel_x = -8;
	pixel_y = 8
	},
/obj/machinery/atmospherics/pipe/simple/scrubbers/hidden/layer4{
	dir = 6
	},
/obj/structure/closet/secure_closet/wall{
	dir = 4;
	name = "fridge";
	pixel_x = -32
	},
/obj/item/reagent_containers/food/snacks/grown/mushroom/jupitercup,
/obj/item/reagent_containers/food/snacks/grown/mushroom/jupitercup,
/obj/item/reagent_containers/food/drinks/bottle/hcider,
/obj/item/reagent_containers/food/snacks/energybar,
/obj/item/reagent_containers/food/snacks/energybar,
/obj/effect/turf_decal/borderfloorblack{
	dir = 1
	},
/obj/item/reagent_containers/food/snacks/grown/ash_flora/cactus_fruit,
/obj/item/reagent_containers/food/snacks/grown/ash_flora/cactus_fruit,
/obj/item/reagent_containers/food/snacks/grown/ash_flora/cactus_fruit,
/obj/item/reagent_containers/food/snacks/grown/ash_flora/cactus_fruit,
/obj/item/reagent_containers/food/snacks/energybar,
/obj/item/reagent_containers/food/drinks/bottle/lizardwine,
/obj/item/reagent_containers/food/drinks/bottle/wine,
/obj/item/reagent_containers/food/snacks/grown/citrus/lemon,
/turf/open/floor/plasteel/tech,
/area/ship/hallway/central)
"lQ" = (
/obj/machinery/atmospherics/pipe/layer_manifold/visible{
	dir = 4
	},
/turf/closed/wall/mineral/plastitanium/nodiagonal,
/area/ship/engineering/engine)
"me" = (
/obj/machinery/door/airlock/hatch{
	name = "External Hatch";
	id_tag = getout
	},
/obj/structure/fans/tiny,
/turf/open/floor/plasteel/tech/grid,
/area/ship/hallway/central)
"mx" = (
/obj/machinery/power/shuttle/engine/electric/premium{
	dir = 4
	},
/obj/structure/cable{
	icon_state = "0-4"
	},
/obj/structure/catwalk/over,
/turf/open/floor/plating,
/area/ship/engineering/engine)
"mC" = (
/obj/structure/cable{
	icon_state = "1-4"
	},
/obj/machinery/atmospherics/pipe/simple/scrubbers/hidden/layer4{
	dir = 9
	},
/obj/machinery/atmospherics/pipe/simple/supply/hidden/layer2{
	dir = 5
	},
/turf/open/floor/wood/ebony,
/area/ship/crew)
"mP" = (
/obj/structure/window/reinforced{
	dir = 4
	},
/obj/machinery/computer/helm{
	dir = 8;
	icon_state = "computer-right"
	},
/turf/open/floor/plasteel/tech,
/area/ship/bridge)
"mW" = (
/obj/structure/window/reinforced,
/obj/structure/window/reinforced{
	dir = 4
	},
/obj/machinery/modular_computer/console/preset/civilian{
	dir = 8
	},
/turf/open/floor/plasteel/tech,
/area/ship/bridge)
"nh" = (
/turf/template_noop,
/area/template_noop)
"oq" = (
/obj/structure/catwalk/over/plated_catwalk/dark,
/obj/structure/cable{
	icon_state = "4-8"
	},
/obj/structure/cable{
	icon_state = "2-8"
	},
/obj/machinery/atmospherics/pipe/manifold/supply/hidden/layer2{
	dir = 1
	},
/obj/machinery/atmospherics/pipe/manifold/scrubbers/hidden/layer4{
	dir = 1
	},
/turf/open/floor/plating,
/area/ship/hallway/central)
"oD" = (
/obj/machinery/atmospherics/components/unary/outlet_injector/on{
	volume_rate = 200;
	dir = 4
	},
/obj/structure/catwalk/over,
/turf/open/floor/plating,
/area/ship/engineering/engine)
"qj" = (
/obj/structure/window/reinforced,
/obj/structure/curtain/bounty,
/obj/structure/window/reinforced{
	dir = 4
	},
/obj/structure/closet/wall{
	dir = 8;
	pixel_x = 30
	},
/obj/structure/table/wood/reinforced,
/obj/item/reagent_containers/glass/rag,
/obj/item/canvas/twentythreeXtwentythree,
/obj/item/toy/crayon/spraycan,
/obj/item/gun/ballistic/automatic/pistol/m1911,
/obj/item/ammo_box/magazine/m45,
/obj/item/ammo_box/magazine/m45,
/obj/item/ammo_box/c45,
/turf/open/floor/wood/ebony,
/area/ship/crew)
"rP" = (
/obj/structure/catwalk/over/plated_catwalk/dark,
/obj/structure/cable{
	icon_state = "4-8"
	},
/obj/structure/cable{
	icon_state = "0-8"
	},
/obj/machinery/atmospherics/pipe/simple/supply/hidden/layer2{
	dir = 4
	},
/obj/machinery/atmospherics/pipe/simple/scrubbers/hidden/layer4{
	dir = 4
	},
/obj/machinery/light{
	pixel_y = -30
	},
/obj/machinery/power/apc/auto_name/directional/north,
/obj/machinery/light_switch{
	pixel_y = 23;
	pixel_x = 10
	},
/turf/open/floor/plating,
/area/ship/hallway/central)
"sh" = (
/obj/structure/cable{
	icon_state = "4-9"
	},
/obj/structure/cable{
	icon_state = "4-10"
	},
/obj/machinery/atmospherics/pipe/simple/scrubbers/hidden/layer4{
	dir = 9
	},
/obj/machinery/atmospherics/pipe/simple/supply/hidden/layer2,
/obj/machinery/cryopod{
	dir = 1
	},
/obj/effect/turf_decal/techfloor/orange/corner,
/turf/open/floor/plasteel/tech,
/area/ship/engineering/engine)
"sy" = (
/obj/machinery/power/smes/shuttle/precharged{
	dir = 4
	},
/obj/structure/window/reinforced{
	dir = 8
	},
/obj/machinery/door/window/eastleft,
/obj/machinery/door/poddoor/preopen{
	id = hotgate;
	name = "thruster blast door";
	dir = 4
	},
/obj/structure/cable{
	icon_state = "0-8"
	},
/turf/open/floor/plating,
/area/ship/engineering/engine)
"ty" = (
/obj/structure/cable{
	icon_state = "4-8"
	},
/obj/machinery/atmospherics/pipe/simple/supply/hidden/layer2{
	dir = 4
	},
/obj/machinery/atmospherics/pipe/simple/scrubbers/hidden/layer4{
	dir = 4
	},
/obj/machinery/door/firedoor/border_only{
	dir = 8
	},
/obj/machinery/door/firedoor/border_only{
	dir = 4
	},
/obj/machinery/door/airlock/maintenance_hatch{
	dir = 4;
	name = "Engine"
	},
/turf/open/floor/plasteel/tech/grid,
/area/ship/engineering/engine)
"uH" = (
/obj/structure/cable/yellow{
	icon_state = "1-4"
	},
/obj/structure/closet/wall/orange{
	dir = 1;
	pixel_y = -30;
	name = "fuel bin"
	},
/obj/item/stack/sheet/mineral/plasma/twenty,
/obj/structure/table,
/obj/machinery/cell_charger{
	pixel_x = -2;
	pixel_y = 1
	},
/obj/structure/catwalk/over,
/turf/open/floor/plating,
/area/ship/engineering/engine)
"Ao" = (
/obj/machinery/door/airlock/grunge{
	name = "Living Quarters"
	},
/obj/structure/cable{
	icon_state = "1-2"
	},
/obj/machinery/atmospherics/pipe/simple/scrubbers/hidden/layer4,
/obj/machinery/atmospherics/pipe/simple/supply/hidden/layer2,
/obj/machinery/door/firedoor/border_only{
	dir = 1
	},
/obj/machinery/door/firedoor/border_only,
/turf/open/floor/plasteel/tech/grid,
/area/ship/crew)
"AG" = (
/obj/structure/cable{
	icon_state = "1-4"
	},
/obj/machinery/atmospherics/pipe/manifold/supply/hidden/layer2{
	dir = 8
	},
/obj/machinery/atmospherics/pipe/manifold/scrubbers/hidden/layer4,
/obj/effect/turf_decal/borderfloorblack{
	dir = 1
	},
/turf/open/floor/plasteel/tech,
/area/ship/hallway/central)
"AO" = (
/obj/machinery/atmospherics/components/unary/vent_scrubber/on/layer4,
/obj/machinery/light{
	dir = 1;
	pixel_y = 30
	},
/obj/effect/turf_decal/corner_techfloor_grid{
	dir = 5
	},
/obj/structure/closet/crate/wooden,
/turf/open/floor/plasteel/tech,
/area/ship/engineering/engine)
"Ch" = (
/turf/closed/wall/mineral/plastitanium/nodiagonal,
/area/ship/hallway/central)
"Cj" = (
/obj/structure/catwalk/over,
/turf/open/floor/plating/airless,
/area/ship/external)
"Db" = (
/obj/structure/cable{
	icon_state = "0-2"
	},
/obj/structure/cable{
	icon_state = "1-2"
	},
/obj/structure/cable{
	icon_state = "2-8"
	},
/obj/machinery/autolathe,
/obj/item/stack/sheet/metal/twenty,
/obj/item/stack/sheet/glass/twenty,
/obj/machinery/power/apc/auto_name/directional/east,
/obj/machinery/light_switch{
	dir = 8;
	pixel_x = 20;
	pixel_y = -10
	},
/obj/effect/turf_decal/techfloor/orange,
/turf/open/floor/plasteel/tech,
/area/ship/engineering/engine)
"Di" = (
/obj/machinery/atmospherics/pipe/manifold/supply/hidden/layer2{
	dir = 1
	},
/obj/machinery/atmospherics/pipe/simple/scrubbers/hidden/layer4{
	dir = 4
	},
/turf/open/floor/plasteel/tech,
/area/ship/engineering/engine)
"Dr" = (
/obj/structure/catwalk/over/plated_catwalk/dark,
/obj/structure/cable{
	icon_state = "4-8"
	},
/obj/machinery/atmospherics/pipe/simple/supply/hidden/layer2{
	dir = 4
	},
/obj/machinery/atmospherics/pipe/simple/scrubbers/hidden/layer4{
	dir = 4
	},
/obj/machinery/firealarm{
	pixel_y = -30
	},
/turf/open/floor/plating,
/area/ship/hallway/central)
"DA" = (
/turf/closed/wall/mineral/plastitanium,
/area/ship/engineering/engine)
"DF" = (
/obj/machinery/power/terminal{
	dir = 4
	},
/obj/structure/cable/yellow{
	icon_state = "0-2"
	},
/obj/structure/catwalk/over,
/turf/open/floor/plating,
/area/ship/engineering/engine)
"DT" = (
/obj/structure/catwalk/over/plated_catwalk/dark,
/obj/structure/cable{
	icon_state = "4-8"
	},
/obj/machinery/atmospherics/pipe/simple/supply/hidden/layer2{
	dir = 4
	},
/obj/machinery/atmospherics/pipe/simple/scrubbers/hidden/layer4{
	dir = 4
	},
/obj/structure/closet/wall/blue{
	pixel_y = 30;
	name = "mining tools locker";
	pixel_x = -6
	},
/obj/item/clothing/glasses/meson,
/obj/item/kitchen/knife/combat/survival,
/obj/item/pickaxe,
/obj/item/mining_scanner,
/obj/item/storage/bag/ore,
/obj/item/clothing/suit/space/hardsuit/mining/independent,
/obj/item/clothing/mask/gas,
/obj/machinery/button/door{
	pixel_y = 34;
	pixel_x = 10;
	normaldoorcontrol = 1;
	specialfunctions = 4;
	id = getout;
	name = "entrance lock"
	},
/obj/item/flashlight/seclite,
/obj/item/radio,
/obj/item/gps,
/obj/item/reagent_containers/hypospray/medipen/survival,
/obj/item/reagent_containers/hypospray/medipen/survival,
/obj/item/tank/internals/emergency_oxygen/double,
/obj/item/gun/ballistic/shotgun/winchester,
/obj/item/ammo_box/c38_box,
/turf/open/floor/plating,
/area/ship/hallway/central)
"DV" = (
/obj/structure/window/reinforced{
	dir = 1
	},
/obj/structure/table/reinforced,
/obj/structure/cable{
	icon_state = "0-2"
	},
/obj/machinery/atmospherics/components/unary/vent_scrubber/on/layer4,
/obj/item/storage/fancy/cigarettes/cigpack_midori{
	pixel_x = -1;
	pixel_y = 6
	},
/obj/item/storage/fancy/cigarettes/cigpack_syndicate{
	pixel_y = 2;
	pixel_x = -6
	},
/obj/item/lighter{
	pixel_y = -2;
	pixel_x = 2
	},
/obj/machinery/power/apc/auto_name/directional/west,
/obj/machinery/light_switch{
	dir = 4;
	pixel_x = -20;
	pixel_y = 10
	},
/turf/open/floor/plasteel/tech,
/area/ship/bridge)
"EB" = (
/obj/structure/railing{
	dir = 4
	},
/obj/structure/railing{
	dir = 8
	},
/obj/docking_port/mobile{
	callTime = 250;
	can_move_docking_ports = 1;
	dir = 2;
	launch_status = 0;
	port_direction = 8;
	preferred_direction = 4
	},
/turf/open/floor/plasteel/stairs/old{
	dir = 1
	},
/area/ship/external)
"Gc" = (
/turf/closed/wall/mineral/plastitanium/nodiagonal,
/area/ship/engineering/engine)
"Gv" = (
/obj/machinery/atmospherics/pipe/simple/scrubbers/hidden/layer4{
	dir = 4
	},
/obj/structure/closet/wall/orange{
	dir = 4;
	pixel_x = -30;
	name = "tool locker"
	},
/obj/item/storage/toolbox/mechanical,
/obj/item/storage/toolbox/electrical,
/obj/item/clothing/head/welding,
/obj/item/clothing/gloves/color/yellow,
/obj/item/multitool,
/obj/structure/catwalk/over,
/obj/item/areaeditor/shuttle,
/turf/open/floor/plating,
/area/ship/engineering/engine)
"GC" = (
/obj/structure/catwalk/over/plated_catwalk/dark,
/obj/structure/cable{
	icon_state = "2-8"
	},
/obj/machinery/atmospherics/pipe/simple/supply/hidden/layer2{
	dir = 10
	},
/obj/machinery/atmospherics/pipe/simple/scrubbers/hidden/layer4{
	dir = 10
	},
/obj/machinery/airalarm/directional/east,
/obj/structure/closet/wall/white/med{
	pixel_y = 30;
	name = "medical supplies"
	},
/obj/item/clothing/gloves/color/latex,
/obj/item/reagent_containers/medigel/silver_sulf,
/obj/item/reagent_containers/medigel/styptic,
/obj/item/stack/medical/suture,
/obj/item/stack/medical/suture,
/obj/item/reagent_containers/pill/patch/styptic,
/obj/item/reagent_containers/pill/patch/styptic,
/obj/item/reagent_containers/pill/patch/silver_sulf,
/obj/item/reagent_containers/pill/patch/silver_sulf,
/obj/item/stack/medical/splint,
/obj/item/stack/medical/mesh,
/obj/item/stack/medical/mesh,
/obj/item/stack/medical/gauze/twelve,
/obj/item/stack/medical/bruise_pack,
/obj/item/stack/medical/ointment,
/obj/item/healthanalyzer,
/obj/item/reagent_containers/spray/rhigoxane,
/obj/item/storage/pill_bottle/charcoal,
/obj/item/storage/pill_bottle/iron,
/obj/item/reagent_containers/hypospray/medipen/salbutamol,
/obj/item/reagent_containers/hypospray/medipen,
/obj/item/storage/pill_bottle/trophazole,
/turf/open/floor/plating,
/area/ship/hallway/central)
"GR" = (
/obj/structure/catwalk/over/plated_catwalk/dark,
/obj/structure/cable{
	icon_state = "4-8"
	},
/obj/machinery/atmospherics/pipe/simple/supply/hidden/layer2{
	dir = 4
	},
/obj/machinery/atmospherics/pipe/simple/scrubbers/hidden/layer4{
	dir = 4
	},
/turf/open/floor/plating,
/area/ship/hallway/central)
"HA" = (
/obj/structure/curtain/bounty,
/obj/structure/window/reinforced{
	dir = 1
	},
/obj/structure/table/wood/reinforced,
/obj/machinery/jukebox/boombox{
	pixel_x = -2;
	pixel_y = -4
	},
/turf/open/floor/plating,
/area/ship/hallway/central)
"JB" = (
/obj/structure/curtain{
	opaque_closed = 1
	},
/obj/machinery/shower{
	pixel_y = 18
	},
/obj/item/soap/deluxe,
/obj/machinery/atmospherics/components/unary/vent_scrubber/on/layer4{
	dir = 4
	},
/obj/structure/closet/wall/white{
	dir = 4;
	pixel_x = -30;
	name = "soap cubby"
	},
/obj/machinery/airalarm/directional/south,
/turf/open/floor/plasteel/mono/white,
/area/ship/crew)
"KA" = (
/obj/machinery/airalarm/directional/east,
/obj/effect/turf_decal/corner_techfloor_grid{
	dir = 5
	},
/obj/structure/table,
/obj/structure/bedsheetbin,
/obj/structure/extinguisher_cabinet/directional/north,
/turf/open/floor/plasteel/tech,
/area/ship/engineering/engine)
"KO" = (
/obj/machinery/power/terminal{
	dir = 8
	},
/obj/structure/cable{
	icon_state = "0-2"
	},
/obj/machinery/button/door{
	pixel_y = 26;
	id = hotgate;
	name = "thruster gates"
	},
/obj/structure/catwalk/over,
/turf/open/floor/plating,
/area/ship/engineering/engine)
"Md" = (
/obj/machinery/power/terminal{
	dir = 8
	},
/obj/structure/cable{
	icon_state = "0-6"
	},
/obj/structure/cable{
	icon_state = "1-6"
	},
/obj/structure/catwalk/over,
/turf/open/floor/plating,
/area/ship/engineering/engine)
"OO" = (
/obj/structure/cable{
	icon_state = "4-8"
	},
/obj/machinery/atmospherics/pipe/simple/supply/hidden/layer2{
	dir = 4
	},
/obj/machinery/atmospherics/pipe/simple/scrubbers/hidden/layer4{
	dir = 4
	},
/obj/effect/turf_decal/borderfloorblack/corner{
	dir = 1
	},
/obj/machinery/holopad/emergency/command,
/obj/structure/extinguisher_cabinet/directional/north{
	pixel_x = 2
	},
/turf/open/floor/plasteel/tech,
/area/ship/hallway/central)
"Qn" = (
/obj/machinery/atmospherics/pipe/manifold/scrubbers/hidden/layer4{
	dir = 8
	},
/obj/machinery/atmospherics/pipe/simple/supply/hidden/layer2{
	dir = 6
	},
/turf/open/floor/plasteel/tech,
/area/ship/engineering/engine)
"QR" = (
/obj/structure/cable{
	icon_state = "0-8"
	},
/obj/machinery/atmospherics/components/unary/vent_pump/on/layer2{
	dir = 8
	},
/obj/machinery/light{
	dir = 4;
	pixel_x = 30
	},
/obj/machinery/power/apc/auto_name/directional/north,
/obj/machinery/light_switch{
	pixel_y = 23;
	pixel_x = 10
	},
/obj/structure/bed/double,
/obj/item/bedsheet/double/purple,
/turf/open/floor/wood/ebony,
/area/ship/crew)
"RG" = (
/obj/structure/window/reinforced{
	dir = 1
	},
/obj/structure/curtain/bounty,
/obj/structure/window/reinforced{
	dir = 8
	},
/obj/structure/window/reinforced{
	dir = 4
	},
/obj/structure/table/wood/reinforced,
/obj/item/radio/old{
	pixel_y = 5
	},
/obj/item/paper_bin{
	pixel_x = -5;
	pixel_y = 3
	},
/obj/item/pen,
/turf/open/floor/plasteel/tech,
/area/ship/hallway/central)
"Sl" = (
/obj/machinery/light/floor,
/obj/structure/catwalk/over,
/turf/open/floor/plating/airless,
/area/ship/external)
"Sx" = (
/obj/structure/window/reinforced{
	dir = 4
	},
/obj/structure/window/reinforced{
	dir = 1
	},
/obj/machinery/computer/cargo/express{
	dir = 8;
	icon_state = "computer-left"
	},
/turf/open/floor/plasteel/tech,
/area/ship/bridge)
"TL" = (
/turf/closed/wall/mineral/plastitanium/nodiagonal,
/area/ship/crew)
"TY" = (
/obj/machinery/power/smes/engineering,
/obj/structure/cable,
/obj/structure/catwalk/over,
/turf/open/floor/plating,
/area/ship/engineering/engine)
"UR" = (
/obj/machinery/atmospherics/components/unary/vent_pump/on/layer2{
	dir = 1
	},
/obj/structure/cable{
	icon_state = "4-8"
	},
/obj/effect/turf_decal/techfloor/orange,
/turf/open/floor/plasteel/tech,
/area/ship/engineering/engine)
"Vc" = (
/obj/machinery/firealarm{
	dir = 1;
	pixel_y = 30
	},
/obj/effect/turf_decal/corner_techfloor_grid{
	dir = 5
	},
/obj/machinery/washing_machine,
/turf/open/floor/plasteel/tech,
/area/ship/engineering/engine)
"Vr" = (
/obj/structure/window/reinforced,
/obj/structure/table/reinforced,
/obj/machinery/atmospherics/components/unary/vent_pump/on/layer2{
	dir = 1
	},
/obj/machinery/airalarm/directional/west,
/obj/item/radio/intercom/wideband/table,
/turf/open/floor/plasteel/tech,
/area/ship/bridge)
"Wc" = (
/obj/machinery/power/terminal{
	dir = 8
	},
/obj/structure/cable,
/obj/structure/catwalk/over,
/turf/open/floor/plating,
/area/ship/engineering/engine)
"Wf" = (
/obj/structure/table,
/obj/machinery/atmospherics/components/unary/vent_scrubber/on/layer4{
	dir = 1
	},
/obj/item/storage/bag/tray,
/obj/item/reagent_containers/glass/bowl,
/obj/item/reagent_containers/glass/bowl,
/obj/item/kitchen/rollingpin,
/obj/item/kitchen/knife,
/obj/structure/closet/wall/white{
	dir = 4;
	pixel_x = -30;
	name = "utinsels pantry"
	},
/obj/item/reagent_scanner,
/obj/item/reagent_containers/glass/beaker/large,
/obj/item/reagent_containers/glass/beaker/large,
/obj/item/reagent_containers/spray,
/obj/item/reagent_containers/glass/filter,
/turf/open/floor/plasteel/tech,
/area/ship/hallway/central)
"Ws" = (
/obj/machinery/power/smes/shuttle/precharged{
	dir = 4
	},
/obj/structure/window/reinforced{
	dir = 8
	},
/obj/machinery/door/window/eastright,
/obj/machinery/door/poddoor/preopen{
	id = hotgate;
	name = "thruster blast door";
	dir = 4
	},
/obj/structure/cable{
	icon_state = "0-8"
	},
/turf/open/floor/plating,
/area/ship/engineering/engine)
"WI" = (
/turf/closed/wall/mineral/plastitanium,
/area/ship/hallway/central)
"Xs" = (
/obj/structure/curtain/bounty,
/obj/structure/table,
/obj/structure/window/reinforced,
/turf/open/floor/plating,
/area/ship/hallway/central)
"XI" = (
/obj/machinery/power/terminal{
	dir = 8
	},
/obj/structure/cable{
	icon_state = "0-5"
	},
/obj/structure/cable{
	icon_state = "2-5"
	},
/obj/structure/catwalk/over,
/turf/open/floor/plating,
/area/ship/engineering/engine)
"YK" = (
/obj/structure/closet/wall{
	pixel_y = 30;
	name = "gardening supplies"
	},
/obj/item/cultivator/rake,
/obj/item/shovel/spade,
/obj/item/shovel,
/obj/item/clothing/gloves/botanic_leather,
/obj/item/plant_analyzer,
/obj/item/reagent_containers/glass/bucket/wooden,
/obj/item/seeds/chanter/jupitercup,
/obj/item/seeds/chanter/jupitercup,
/obj/item/seeds/lavaland/cactus,
/obj/item/seeds/lavaland/cactus,
/obj/item/seeds/lavaland/fireblossom,
/obj/item/seeds/lavaland/inocybe,
/obj/item/seeds/random,
/obj/item/seeds/tobacco/space,
/obj/item/stack/sheet/mineral/sandstone/thirty,
/obj/item/seeds/aloe,
/obj/item/seeds/cannabis,
/obj/item/reagent_containers/glass/bottle/nutrient/ez,
/obj/item/reagent_containers/glass/bottle/nutrient/ez,
/obj/item/reagent_containers/glass/bottle/nutrient/rh,
/obj/item/reagent_containers/glass/bottle/nutrient/l4z,
/obj/structure/catwalk/over,
/turf/open/floor/plating/airless,
/area/ship/external)
"Zb" = (
/obj/machinery/door/airlock/hatch{
	name = "Cockpit";
	dir = 4
	},
/obj/structure/cable{
	icon_state = "4-8"
	},
/obj/machinery/atmospherics/pipe/simple/supply/hidden/layer2{
	dir = 4
	},
/obj/machinery/atmospherics/pipe/simple/scrubbers/hidden/layer4{
	dir = 4
	},
/obj/machinery/door/firedoor/border_only{
	dir = 8
	},
/obj/machinery/door/firedoor/border_only{
	dir = 4
	},
/turf/open/floor/plasteel/tech/grid,
/area/ship/bridge)

(1,1,1) = {"
nh
mx
mx
oD
mx
mx
nh
"}
(2,1,1) = {"
DA
sy
Ws
lQ
sy
Ws
DA
"}
(3,1,1) = {"
Gc
KO
Md
Gv
XI
Wc
Gc
"}
(4,1,1) = {"
Gc
AO
Qn
sh
gt
eJ
Gc
"}
(5,1,1) = {"
Gc
Vc
Di
UR
DF
uH
Gc
"}
(6,1,1) = {"
Gc
KA
hn
Db
TY
bJ
Gc
"}
(7,1,1) = {"
DA
Gc
ty
Gc
Gc
Gc
DA
"}
(8,1,1) = {"
nh
Ch
DT
TL
JB
TL
nh
"}
(9,1,1) = {"
EB
me
oq
Ao
mC
hB
nh
"}
(10,1,1) = {"
nh
RG
Dr
TL
QR
qj
nh
"}
(11,1,1) = {"
nh
Ch
rP
TL
TL
TL
nh
"}
(12,1,1) = {"
nh
HA
GR
jz
Wf
Xs
nh
"}
(13,1,1) = {"
Cj
Ch
GC
AG
hv
Ch
YK
"}
(14,1,1) = {"
Cj
WI
Ch
OO
Ch
WI
Cj
"}
(15,1,1) = {"
Cj
nh
gN
Zb
gN
nh
Cj
"}
(16,1,1) = {"
Sl
nh
DV
aK
Vr
nh
Sl
"}
(17,1,1) = {"
nh
nh
Sx
mP
mW
nh
nh
"}
